29 29 29 29 29 29 29 29 29 29 29 29 29 29 29 29 29 29 29 29 29 29 29 29 29 29 29 29 29 29 29 29 29 29 29 29 29 29 29 29 29 29 29 29 29 29 29 29 29 29
29 29 29 29 29 29 29 29 29 29 29 29 29 29 29 29 29 29 29 29 29 29 29 29 29 29 29 29 29 29 29 29 29 29 29 29 29 29 29 29 29 29 29 29 29 29 29 29 29 29
29 29 29 29 29 29 29 29 29 29 29 29 29 29 29 29 29 29 29 29 29 29 29 29 29 29 29 29 29 29 29 29 29 29 29 29 29 29 29 29 29 29 29 29 29 29 29 29 29 29
29 29 29 29 29 29 29 29 29 29 29 29 29 33 39 39 39 39 39 39 39 39 39 39 34 29 29 29 29 29 29 29 29 29 29 29 29 29 29 29 29 29 29 29 29 29 29 29 29 29
29 29 29 29 29 29 29 29 29 29 29 33 39 32 10 10 10 10 10 10 10 10 10 10 37 29 29 29 29 29 29 29 29 29 29 29 29 29 29 29 29 29 29 29 29 29 29 29 29 29
29 29 29 29 29 29 29 29 29 33 39 32 28 28 28 28 28 28 28 28 28 28 28 10 37 29 29 29 29 29 29 29 29 29 29 29 29 29 29 29 29 29 29 29 29 29 29 29 29 29
29 29 29 29 29 29 29 29 29 38 10 10 28 24 24 24 24 24 24 24 24 24 28 10 37 29 29 29 29 29 29 29 29 29 29 29 29 29 29 29 29 29 29 29 29 29 29 29 29 29
29 29 29 29 29 29 29 29 29 38 10 10 28 24 24 24 24 24 24 24 24 24 28 10 37 29 29 29 29 29 29 29 29 29 29 29 29 29 29 29 29 29 29 29 29 29 29 29 29 29
29 29 29 29 29 29 29 29 29 38 10 10 28 24 24 24 24 24 24 24 24 24 28 10 37 29 29 29 29 29 29 29 29 29 29 29 29 29 29 29 29 29 29 29 29 29 29 29 29 29
29 29 29 29 29 29 29 29 29 38 10 10 28 24 24 24 24 24 24 24 24 24 28 10 37 29 29 29 29 29 29 29 29 29 29 29 29 29 29 29 29 29 29 29 29 29 29 29 29 29
29 29 29 29 29 29 29 33 39 32 10 10 28 24 24 24 24 24 24 24 24 24 28 10 31 39 39 34 29 29 29 29 29 29 29 29 29 29 29 29 29 29 29 29 29 29 29 29 29 29
29 29 29 29 29 29 29 38 10 10 10 10 28 24 24 24 24 24 24 24 24 24 28 10 10 10 10 31 39 39 39 39 39 39 39 39 39 39 39 39 39 39 34 29 29 29 29 29 29 29
29 29 29 29 29 29 29 38 10 10 10 10 28 28 28 28 24 28 28 28 28 28 28 10 10 10 10 10 10 10 10 10 10 10 10 10 10 10 10 10 10 10 37 29 29 29 29 29 29 29
29 29 29 29 29 29 29 38 10 10 10 10 17 21 21 23 24 22 21 21 21 21 18 10 10 10 10 10 10 10 10 10 10 10 10 10 10 10 10 10 10 10 37 29 29 29 29 29 29 29
29 29 29 29 29 29 29 38 10 10 10 10 10 10 26 20 24 19 26 26 26 10 10 10 10 10 10 10 10 10 10 10 10 10 10 10 10 10 10 10 10 10 37 29 29 29 29 29 29 29
29 29 29 29 29 29 29 38 10 10 10 10 10 10 26 20 24 19 26 26 26 10 10 10 10 11 10 10 10 10 10 11 10 10 10 10 11 10 10 11 10 10 37 29 29 29 29 29 29 29
29 29 29 29 29 29 29 38 10 10 10 10 10 10 26 20 24 19 26 26 26 10 10 10 10 10 11 10 10 10 26 26 26 26 26 10 10 10 10 10 10 10 37 29 29 29 29 29 29 29
29 29 29 29 29 29 29 38 10 10 10 10 10 10 26 20 24 19 26 26 26 10 11 10 10 10 10 10 10 26 15 12 12 12 16 26 10 10 11 10 10 10 37 29 29 29 29 29 29 29
29 29 29 29 29 29 29 38 10 10 10 10 10 10 26 20 24 19 26 26 26 26 26 26 10 10 11 10 26 15 14 24 24 24 13 16 26 10 10 10 10 10 37 29 29 29 29 29 29 29
29 29 29 29 29 29 29 38 10 10 10 10 10 10 26 20 24 19 10 26 26 26 26 26 26 26 26 26 15 14 24 24 24 24 24 13 16 26 10 10 10 10 37 29 29 29 29 29 29 29
29 29 29 29 29 29 29 38 10 10 10 10 10 10 26 20 24 13 12 12 12 12 12 12 12 12 12 12 14 24 24 24 24 24 24 24 19 26 10 10 10 10 37 29 29 29 29 29 29 29
29 29 29 29 29 29 29 38 10 10 10 10 10 10 26 20 24 24 24 24 24 24 24 24 24 24 24 24 24 24 24 24 24 24 24 24 19 26 10 10 10 10 37 29 29 29 29 29 29 29
29 29 29 29 29 29 29 38 10 10 10 10 10 10 26 17 21 21 21 21 21 21 21 21 21 21 21 21 23 24 24 24 24 24 24 24 19 26 10 10 10 10 37 29 29 29 29 29 29 29
29 29 29 29 29 29 29 38 10 10 10 10 10 10 26 26 26 26 26 26 26 26 26 26 26 26 26 26 17 23 24 24 24 24 24 22 18 26 10 10 10 10 37 29 29 29 29 29 29 29
29 29 29 29 29 29 29 38 10 10 10 10 10 10 10 10 10 10 10 10 10 10 10 10 10 10 10 10 26 17 23 24 24 24 22 18 26 26 11 10 10 10 37 29 29 29 29 29 29 29
29 29 29 29 29 29 29 38 10 10 10 10 10 10 10 10 11 10 10 10 10 10 10 10 10 11 10 10 10 26 17 23 24 22 18 26 10 10 10 10 10 10 37 29 29 29 29 29 29 29
29 29 29 29 29 29 29 38 10 10 10 10 10 10 10 10 10 10 10 10 11 10 10 10 10 10 10 10 11 10 26 20 24 19 26 10 10 10 10 10 10 10 37 29 29 29 29 29 29 29
29 29 29 29 29 29 29 38 10 10 10 10 10 10 10 10 10 10 10 10 10 10 11 10 10 10 10 10 10 10 26 20 24 19 26 10 10 10 10 10 10 10 37 29 29 29 29 29 29 29
29 29 29 29 29 29 29 38 10 10 10 10 10 10 10 10 10 10 10 10 10 10 10 10 11 10 10 10 10 10 26 20 24 19 26 10 11 10 10 10 10 10 37 29 29 29 29 29 29 29
29 29 29 29 29 29 29 38 10 10 10 10 10 10 10 10 10 10 10 10 10 10 10 10 10 10 10 10 11 10 26 20 24 19 26 10 10 10 10 10 10 10 37 29 29 29 29 29 29 29
29 29 29 29 29 29 29 38 10 10 10 10 10 10 10 10 10 10 10 10 10 10 10 10 10 10 10 10 10 10 26 20 24 19 26 10 10 10 10 10 10 10 37 29 29 29 29 29 29 29
29 29 29 29 29 29 29 38 10 10 10 10 10 10 10 10 10 10 10 10 10 10 10 10 10 10 10 10 10 10 26 20 24 19 26 10 10 10 10 10 10 10 37 29 29 29 29 29 29 29
29 29 29 29 29 29 29 38 10 10 10 10 10 10 10 10 10 10 10 10 10 10 10 10 10 10 10 10 10 10 26 20 24 19 26 10 10 11 10 10 10 10 37 29 29 29 29 29 29 29
29 29 29 29 29 29 29 38 10 10 10 10 10 10 10 10 10 10 10 10 10 10 10 10 10 10 10 11 10 10 26 20 24 19 26 10 10 10 10 10 10 10 37 29 29 29 29 29 29 29
29 29 29 29 29 29 29 38 10 10 10 10 10 10 10 10 10 10 10 10 10 10 10 10 10 10 10 10 10 10 26 20 24 19 26 10 10 10 10 10 10 10 37 29 29 29 29 29 29 29
29 29 29 29 29 29 29 38 10 10 10 10 10 10 10 10 10 10 10 10 10 10 10 10 10 10 10 10 10 10 26 17 21 18 26 10 10 10 10 10 10 10 37 29 29 29 29 29 29 29
29 29 29 29 29 29 29 38 10 10 10 10 10 10 10 10 10 10 10 10 10 10 10 10 10 10 10 10 10 26 10 10 10 10 10 26 10 10 10 10 10 10 37 29 29 29 29 29 29 29
29 29 29 29 29 29 29 38 10 10 10 10 10 10 10 10 10 10 10 10 10 10 10 10 10 10 10 10 10 10 10 10 10 11 10 10 10 10 10 10 10 10 37 29 29 29 29 29 29 29
29 29 29 29 29 29 29 38 10 10 10 10 10 10 10 10 10 10 10 10 10 10 10 10 10 10 11 10 10 10 10 11 10 10 10 11 11 10 10 11 10 10 37 29 29 29 29 29 29 29
29 29 29 29 29 29 29 38 10 10 10 10 10 10 10 10 10 10 10 10 10 10 10 10 10 10 10 10 11 10 10 10 11 10 10 11 10 10 10 10 10 10 37 29 29 29 29 29 29 29
29 29 29 29 29 29 29 38 10 10 10 10 10 10 10 10 10 10 10 10 10 10 10 10 10 10 10 10 10 10 11 10 10 10 10 10 10 10 11 10 10 10 37 29 29 29 29 29 29 29
29 29 29 29 29 29 29 38 10 10 10 10 10 10 10 10 10 10 10 10 10 10 10 10 10 10 10 11 11 10 10 10 10 10 11 10 10 10 10 10 10 10 37 29 29 29 29 29 29 29
29 29 29 29 29 29 29 38 10 10 10 10 10 10 10 10 10 10 10 10 10 10 10 10 10 10 10 10 10 11 10 11 10 10 10 10 10 10 11 10 10 10 37 29 29 29 29 29 29 29
29 29 29 29 29 29 29 38 10 10 10 10 10 10 10 10 10 10 10 10 10 10 10 10 10 10 10 10 10 10 10 10 10 10 10 10 10 10 10 10 10 10 37 29 29 29 29 29 29 29
29 29 29 29 29 29 29 35 30 30 30 30 30 30 30 30 30 30 30 30 30 30 30 30 30 30 30 30 30 30 30 30 30 30 30 30 30 30 30 30 30 30 36 29 29 29 29 29 29 29
29 29 29 29 29 29 29 29 29 29 29 29 29 29 29 29 29 29 29 29 29 29 29 29 29 29 29 29 29 29 29 29 29 29 29 29 29 29 29 29 29 29 29 29 29 29 29 29 29 29
29 29 29 29 29 29 29 29 29 29 29 29 29 29 29 29 29 29 29 29 29 29 29 29 29 29 29 29 29 29 29 29 29 29 29 29 29 29 29 29 29 29 29 29 29 29 29 29 29 29
29 29 29 29 29 29 29 29 29 29 29 29 29 29 29 29 29 29 29 29 29 29 29 29 29 29 29 29 29 29 29 29 29 29 29 29 29 29 29 29 29 29 29 29 29 29 29 29 29 29
29 29 29 29 29 29 29 29 29 29 29 29 29 29 29 29 29 29 29 29 29 29 29 29 29 29 29 29 29 29 29 29 29 29 29 29 29 29 29 29 29 29 29 29 29 29 29 29 29 29
29 29 29 29 29 29 29 29 29 29 29 29 29 29 29 29 29 29 29 29 29 29 29 29 29 29 29 29 29 29 29 29 29 29 29 29 29 29 29 29 29 29 29 29 29 29 29 29 29 29







